Detective Conan/	ğŸ•µï¸â€â™‚ï¸ğŸ”ğŸ§ ğŸ’¼
Captain Tsubasa/	âš½ğŸ†ğŸ‡¯ğŸ‡µğŸ‘Ÿ
Dragon Ball Z/	ğŸ‰ğŸ‘ŠğŸ’¥ğŸŒŒ
Naruto/	ğŸ¥·ğŸ¥ğŸ”¥ğŸŒªï¸
One Piece/	ğŸ´â€â˜ ï¸ğŸŒŠğŸ‘’âš“
Digimon Adventure/	ğŸ‰ğŸŒğŸ‘¾ğŸ§’
Hunter x Hunter/	ğŸ¹ğŸ§’ğŸŒ²ğŸ‘Š
Beyblade/	ğŸŒ€âš”ï¸ğŸ†ğŸ‘¦
Slam Dunk/	ğŸ€â›¹ï¸â€â™‚ï¸ğŸ†ğŸ‡¯ğŸ‡µ
Inazuma Eleven/	âš½âš¡ğŸ†ğŸ‘Ÿ
Pokemon/	ğŸ‰âš¡ğŸ®ğŸ”
Doraemon/	ğŸ±ğŸ•°ï¸ğŸ§’ğŸ”§
Tom and Jerry/	ğŸ±ğŸ­ğŸ˜‚ğŸ 
The Adventures of Tintin/	ğŸ•µï¸â€â™‚ï¸ğŸŒğŸš¢ğŸ”
The Smurfs/	ğŸ‘¨â€ğŸ‘©â€ğŸ‘§â€ğŸ‘¦ğŸï¸ğŸ”µğŸ„
The Flintstones/	ğŸ¦•ğŸ ğŸ‘¨â€ğŸ‘©â€ğŸ‘§â€ğŸ‘¦ğŸš—
The Jetsons/	ğŸš€ğŸ ğŸ‘¨â€ğŸ‘©â€ğŸ‘§â€ğŸ‘¦ğŸ¤–
Looney Tunes/	ğŸ°ğŸ¦†ğŸ˜‚ğŸ¬
Scooby-Doo/	ğŸ¶ğŸ•µï¸â€â™‚ï¸ğŸ‘»ğŸš
The Powerpuff Girls/	ğŸ‘§ğŸ‘§ğŸ‘§ğŸ’¥ğŸŒ†
Johnny Bravo/	ğŸ’ªğŸ•¶ï¸ğŸ˜‚ğŸ‘±â€â™‚ï¸
Dexter's Laboratory/	ğŸ§ªğŸ”¬ğŸ‘¨â€ğŸ”¬ğŸ 
Samurai Jack/	ğŸ¥·âš”ï¸ğŸŒŒğŸ‘Š
Courage the Cowardly Dog/	ğŸ¶ğŸ˜±ğŸ‘»ğŸ 
Ed, Edd n Eddy/	ğŸ˜‚ğŸ ğŸ‘¦ğŸ¬
The Grim Adventures of Billy & Mandy/	ğŸ’€ğŸ‘¦ğŸ‘§ğŸ˜‚
Codename: Kids Next Door/	ğŸ§’ğŸ•µï¸â€â™‚ï¸ğŸŒğŸ”
Foster's Home for Imaginary Friends/	ğŸ ğŸ‘»ğŸ‘«ğŸ¨
Ben 10/	ğŸ‘¦ğŸ‘½ğŸ›¡ï¸ğŸ”„
Teen Titans/	ğŸ¦¸â€â™‚ï¸ğŸ¦¸â€â™€ï¸ğŸŒ†ğŸ’¥
Avatar: The Last Airbender/	ğŸŒŠğŸ”¥ğŸŒªï¸ğŸŒ
Winx Club/	ğŸ§šâ€â™€ï¸ğŸŒ¸ğŸ¦‹ğŸ°
Totally Spies!/	ğŸ•µï¸â€â™€ï¸ğŸ‘§ğŸ”ğŸŒ†
Kim Possible/	ğŸ¥·ğŸ§‘â€ğŸ¦°ğŸ¦¸â€â™€ï¸ğŸ“±
Lilo & Stitch/	ğŸ‘½ğŸï¸ğŸ‘§ğŸ¶
The Fairly OddParents/	ğŸ§šâ€â™‚ï¸ğŸ‘¦ğŸ§šâ€â™€ï¸ğŸ 
SpongeBob SquarePants/	ğŸğŸ§½ğŸŒŠğŸ˜‚
Jimmy Neutron/	ğŸ§ ğŸ‘¦ğŸš€ğŸ”¬
Danny Phantom/	ğŸ‘»ğŸ‘¦ğŸ•µï¸â€â™‚ï¸ğŸŒ†
My Life as a Teenage Robot/	ğŸ¤–ğŸ‘§ğŸŒ†ğŸ”§
The Wild Thornberrys/	ğŸ¦ğŸŒğŸšğŸ‘¨â€ğŸ‘©â€ğŸ‘§â€ğŸ‘¦
Rugrats/	ğŸ‘¶ğŸ¼ğŸ ğŸ˜‚
Hey Arnold!/	ğŸ«ğŸ‘¦ğŸ ğŸ˜‚
Rocko's Modern Life/	ğŸ¨ğŸ ğŸ˜‚ğŸŒ†
Invader Zim/	ğŸ‘½ğŸŒ†ğŸ˜‚ğŸ”
The Angry Beavers/	ğŸ¦«ğŸ ğŸ˜‚ğŸŒ²
CatDog/	ğŸ±ğŸ¶ğŸ ğŸ˜‚
Rocket Power/	ğŸ›¹ğŸ„â€â™‚ï¸ğŸ„â€â™€ï¸ğŸŒ†
As Told by Ginger/	ğŸ‘§ğŸ«ğŸ ğŸ˜‚
Invader Zim/	ğŸ‘½ğŸŒ†ğŸ˜‚ğŸ”
