Stranger Things/	ğŸ‘½ğŸ§’ğŸ”¬ğŸ 
The Witcher/	âš”ï¸ğŸ§™â€â™‚ï¸ğŸºğŸ‘‘
Money Heist/	ğŸ’°ğŸ­ğŸ”«ğŸ¦
Bridgerton/	ğŸ‘—ğŸ’‘ğŸ°ğŸ’Œ
The Crown/	ğŸ‘‘ğŸ‡¬ğŸ‡§ğŸ“œğŸ›ï¸
Narcos/	ğŸ’ŠğŸ’µğŸ”«ğŸ‡¨ğŸ‡´
Black Mirror/	ğŸ“ºğŸ§ ğŸ¤–ğŸŒ
Ozark/	ğŸ’µğŸ”«ğŸŒ²ğŸï¸
The Umbrella Academy/	â˜‚ï¸ğŸ¦¸â€â™‚ï¸ğŸ¦¸â€â™€ï¸ğŸ•°ï¸
13 Reasons Why/	ğŸ§ğŸ““ğŸ’”ğŸ•µï¸â€â™‚ï¸
Dark/	ğŸ•°ï¸ğŸ”„ğŸŒŒğŸ‡©ğŸ‡ª
Lucifer/	ğŸ˜ˆğŸ‘¨â€âš–ï¸ğŸ”¥ğŸŒ†
The Queen's Gambit/	â™Ÿï¸ğŸ‘©â€ğŸ¦°ğŸ§ ğŸ†
You/	ğŸ“šğŸ”ªğŸ•µï¸â€â™‚ï¸â¤ï¸
The Haunting of Hill House/	ğŸšï¸ğŸ‘»ğŸ˜±ğŸ›Œ
Emily in Paris/	ğŸ‘—ğŸ—¼ğŸ’ŒğŸ‡«ğŸ‡·
The Mandalorian/	ğŸš€ğŸ‘½ğŸ›¡ï¸ğŸ‘¶
The Office/	ğŸ¢ğŸ˜‚ğŸ“„ğŸ‘”
Breaking Bad/	ğŸ’ŠğŸ”¬ğŸ”«ğŸš™
The Walking Dead/	ğŸ§Ÿâ€â™‚ï¸ğŸ”«ğŸï¸ğŸš¶â€â™‚ï¸
House of Cards/	ğŸ›ï¸ğŸƒğŸ”ªğŸ‡ºğŸ‡¸
Bojack Horseman/	ğŸ´ğŸ·ğŸ¬ğŸ˜‚
The Good Place/	ğŸ˜‡ğŸ‘¿ğŸï¸ğŸ˜‚
Schitt's Creek/	ğŸ˜ï¸ğŸ˜‚ğŸ’µğŸ‘¨â€ğŸ‘©â€ğŸ‘¦
The Great British Bake Off/	ğŸ°ğŸ‡¬ğŸ‡§ğŸ‘©â€ğŸ³ğŸ†
The Last Kingdom/	âš”ï¸ğŸ‘‘ğŸ°ğŸ‡¬ğŸ‡§
Peaky Blinders/	ğŸ§¢ğŸ”«ğŸ™ï¸ğŸ‡¬ğŸ‡§
Stranger Things/	ğŸ‘½ğŸ§’ğŸ”¬ğŸ 
The Dragon Prince/	ğŸ‰ğŸ‘‘ğŸ§™â€â™‚ï¸ğŸŒŒ
The Chilling Adventures of Sabrina/	ğŸ§™â€â™€ï¸ğŸ”®ğŸ‘»ğŸŒ‘
The Dragon Prince/	ğŸ‰ğŸ‘‘ğŸ§™â€â™‚ï¸ğŸŒŒ
The Crown/	ğŸ‘‘ğŸ‡¬ğŸ‡§ğŸ“œğŸ›ï¸
The Stranger/	ğŸ•µï¸â€â™‚ï¸ğŸ”ğŸ¡ğŸ•µï¸â€â™€ï¸
The Society/	ğŸ˜ï¸ğŸ§‘â€ğŸ¤â€ğŸ§‘ğŸ”ğŸŒ
The Politician/	ğŸ›ï¸ğŸ­ğŸ—³ï¸ğŸ‡ºğŸ‡¸
The OA/	ğŸ‘ï¸ğŸŒŒğŸ§ ğŸ”„
The Punisher/	ğŸ”«ğŸ’€ğŸ›¡ï¸ğŸ‡ºğŸ‡¸
The Rain/	ğŸŒ§ï¸ğŸ§Ÿâ€â™‚ï¸ğŸ”¬ğŸï¸
The Spy/	ğŸ•µï¸â€â™‚ï¸ğŸ‡®ğŸ‡±ğŸ”ğŸ”«
The Umbrella Academy/	â˜‚ï¸ğŸ¦¸â€â™‚ï¸ğŸ¦¸â€â™€ï¸ğŸ•°ï¸
The Witcher/	âš”ï¸ğŸ§™â€â™‚ï¸ğŸºğŸ‘‘
The 100/	ğŸš€ğŸŒğŸ§‘â€ğŸ¤â€ğŸ§‘ğŸ”„
The 4400/	ğŸ‘½ğŸ§‘â€ğŸ¤â€ğŸ§‘ğŸ”„ğŸŒŒ
The Alienist/	ğŸ•µï¸â€â™‚ï¸ğŸ”ğŸ§ ğŸ”ª
The Boys/	ğŸ¦¸â€â™‚ï¸ğŸ¦¸â€â™€ï¸ğŸ”ªğŸ’¥
The Expanse/	ğŸš€ğŸŒŒğŸ§‘â€ğŸ¤â€ğŸ§‘ğŸ”„
The Flash/	âš¡ğŸ¦¸â€â™‚ï¸ğŸƒâ€â™‚ï¸ğŸ”„
The Good Doctor/	ğŸ¥ğŸ§‘â€âš•ï¸ğŸ§ â¤ï¸
The Handmaid's Tale/	ğŸ‘©â€ğŸ¦°ğŸ§‘â€âš•ï¸ğŸ”´ğŸ›ï¸
The Innocents/	ğŸ§‘â€ğŸ¤â€ğŸ§‘ğŸ”„ğŸï¸ğŸ”
